111111111111111000000111111111111000000001111111111110000000000000000000000000001
110000000000000000000000000000000000000000000011111110000000000000000000000000001
110000000000000000000000000000000000000000000000000000000000000000000000000000001
110000000000000000000000000000000000000000000000000000000000000000000000000000001
110000000000000000000000000000000000000000011111111111QQQQQ111QQQ111QQQ111QQQ1111
110000000000000000000000000000000000000000111111111110000010000000000000000000001
110111111111111111111111110000000000000001111111111110011000000000000000000000001
112111111111111111111111101110000000000011000011111110000000000000000000000000001
111111111111111111111111100000111000000000000011111111000000000000000000000000001
111111111111111111000111100000000011100000000011111110000000000000000000000000001
111111111111111111000111100000000000000111111111111110011000000000000000000000001
111111111111111111000111100000000000000001000011111110000000000000000000000000001
111111111111111111000111100000000000110000000011111111000000000000000000000000001
111111111111111111000111100000000000010000000001111110000000000000000000000000001
111222222222111111000111100000000011111111111000111110011000000000000000000000001
111200000000000000000000000000000000000000000001111110000000000000000000000000001
111200000000000000000000000000000000000000000011111111000000000000000000000000001
111200000000000000000000000000000000000000000111111110000000000000000000000000001
111222000222111111111111111111111111111111111111111110011000000000000000000000001
111222000221111111111111111111111111111111111111111110000000000000000000000000001
111222000212111111111111111111111111111111111111111111000000000000000000000000001
111222000212111111111111111111111111111111111111111110000000000000000000000000001
111222000212111111111111111111111111111111111111111110011000000000000000000000001
111222000212111111111111111111111111111111111111111110000000000000000000000000001
111222000212111111111111111111111111111111111111111111000000000000000000000000001
111222000212111111111111111111111111111111111111111110000000000000000000000000001
111222000212111111111111111111111111111111111111111110011000000000000000000000001
111222000212111111111111111111111111111111111111111110000000000000000000000000001
111222000212111111111111111111111111111111111111111111000000000000000000000000001
111222000212111111111111111111111111111111111111111110000000000000000000000000001
111222000212111111111111111111111111111111111111111111111111111111111111111111111