000000000000000000000000000000000000000000000000000000000000000000000000000000000
000000000000000000000000000000000000000000000000000000000000000000000000000000000
000000000000000000000000000000000000000000000000000000000000000000000000000000000
0000000000000000000000000000000000000000000000000000000000000000000000000000000N0
000000000000000000000000000000000000000000000000000000000000000000000000000000000
000000N0000000000000N000000000000000000000000000000000000000000000000000000000000
000000000000000000000000000000000000000000000000000000000000000000000000000000000
00000000000000000000000000000000000000000<<<0000000000000000000000000000000000000
00000000000000000000000000000000000000000<<<0000000000000000000000000000000000000
000000000000000000;;;00000000000000000000<<<N000000000000000000000000000000000000
000000000000000000;;;000000000000000000000000000000000000000000000000000000000000
000000000000000000;;;000000000000000000000000000000000000000000000000000000000000
000000000000000000;;;000000000000000000000000000000000000000000000000000000000000
000000000000000000;;;000000000000000000000000000000000000000000000000000000000000
000000000000000000;;;000000000000000000000000000000000000000000000000000000000000
000044444<<<<<<<<<;;;<<<<0000000000<<333<<<<<<<<<00000000000000000000000000000000
00004444<<<<<<9<<<;;;<<<<0700000000<<333<<<<<<<<<00000000000000000000000000000000
0000N44<<<<<<<:<<<;;;<<<00600055000<<333<<<<<<<<<00000000000000000000000000000000
000444444444000000000000000000000000000000000000000000000000000000000000000000000
000444444044400000000000000000000000000000000000000000000000000000000000000000000
000000444044400000000000000000000000000000000000000000000000000000000000000000000
000000444044400000000000000000000000000000000000000000000000000000000000000000000
000000444044400000000000000000000000000000000000000000000000000000000000000000000
000000444044400000000000000000000000000000000000000000000000000000000000000000000
000000444044400000000000000000000000000000000000000000000000000000000000000000000
000000444044400000000000000000000000000000000000000000000000000000000000000000000
000000444044400000000000000000000000000000000000000000000000000000000000000000000
000000444044400000000000000000000000000000000000000000000000000000000000000000000
000000444044400000000000000000000000000000000000000000000000000000000000000000000
0000004440444000000000000000000000000000000000000000000000000000000NPPPPPPPPPPPP0
000000444044400000000000000000000000000000000000000000000000000000000000000000000